5632 352
1 2 3 4 5 6 1 2 1 2 3 4 5 6 1 2 1 2 3 4 7 8 1 2 1 2 3 4 5 6 1 2 9 10 3 4 5 6 9 10 1 2 1 2 1 2 1 2 3 4 5 6 11 11 3 4 12 13 1 2 1 2 9 10 3 4 9 10 3 4 9 10 3 4 9 10 3 4 1 2 9 10 1 2 12 13 12 13 1 2 11 11 3 4 14 15 16 17 17 17 17 17 3 4 17 17 17 17 17 17 17 17 18 19 17 17 18 19 17 17 17 17 17 17 17 17 20 20 1 2 1 2 3 4 12 13 1 2 3 4 9 10 1 2 3 4 5 6 21 22 23 24 1 2 25 26 3 4 23 24 1 2 25 26 3 4 23 24 1 2 7 8 9 10 14 16  20
27 28 3 4 29 30 31 32 33 34 3 4 29 30 31 32 33 34 3 4 7 35 31 32 33 34 3 4 29 30 31 32 27 28 3 4 29 30 11 11 33 34 33 34 33 34 33 34 3 4 36 37 11 11 3 4 33 34 33 34 33 34 27 28 3 4 11 11 3 4 11 11 3 4 11 11 3 4 33 34 11 11 33 34 33 34 33 34 33 34 11 11 3 4 17 39 39 17 17 40 17 17 3 19 17 17 41 17 41 17 41 17 3 19 17 40 3 4 17 17 17 17 41 17 41 17 17 39 33 34 27 28 3 4 33 34 33 34 3 4 11 11 33 34 3 4 29 30 27 28 33 34 42 43 44 45 3 4 46 47 42 43 44 45 3 4 46 47 42 43 7 35 11 11 48 16     20
12 13 3 4 49 50 9 10 1 2 3 4 49 50 9 10 1 2 3 4 5 6 9 10 1 2 3 4 49 50 9 10 12 13 3 4 49 50 11 11 1 2 1 2 1 2 1 2 3 4 51 52 11 11 3 4 1 2 1 2 1 2 12 13 3 4 11 11 3 4 11 11 3 4 11 11 3 4 1 2 11 11 1 2 1 2 1 2 1 2 11 11 3 4 17 39 39 17 54 55 17 17 18 19 17 17 17 17 17 17 17 17 18 19 54 55 3 4 17 17 17 17 17 17 17 17 17 39 1 2 12 13 3 4 1 2 1 2 3 4 11 11 1 2 3 4 49 50 12 13 1 2 3 4 25 26 3 4 23 24 3 4 25 26 3 4 23 24 3 4 5 6 11 11 14 16   20
33 34 3 4 36 37 11 11 33 34 3 4 29 30 11 11 33 34 3 4 29 30 11 11 33 34 3 4 29 30 11 11 33 34 3 4 29 30 11 11 33 34 33 34 56 57 58 59 60 61 62 63 64 64 64 64 65 66 67 68 33 34 33 34 3 4 11 11 3 4 11 11 3 4 11 11 3 4 31 32 11 11 33 34 56 57 58 59 64 64 62 63 60 61 17 39 39 17 17 17 17 17 60 61 17 17 17 17 70 71 70 71 3 4 70 71 3 4 17 17 17 40 17 17 17 17 17 39 62 63 64 64 64 64 65 66 67 68 3 4 11 11 33 34 3 4 36 37 33 34 33 34 3 4 33 34 3 4 33 34 3 4 33 34 3 4 31 32 3 4 36 37 11 11 17 38     20
1 2 3 4 51 52 11 11 1 2 3 4 49 50 11 11 1 2 3 4 49 50 11 11 1 2 3 4 49 50 11 11 1 2 3 4 49 50 11 11 1 2 1 2 72 58 73 20 20 20 20 20 20 20 20 20 20 74 75 76 1 2 1 2 3 4 11 11 3 4 11 11 3 4 11 11 3 4 9 10 11 11 1 2 72 58 73 20 20 20 20 20 20 20 20 20 20 20 20 20 20 20 20 20 17 17 17 17 39 77 39 77 3 4 39 77 3 4 17 17 54 55 20 20 20 20 20 20 20 20 20 20 20 20 20 74 75 76 3 4 11 11 1 2 3 4 51 52 1 2 1 2 3 4 1 2 3 4 1 2 3 4 1 2 3 4 9 10 3 4 51 52 11 11 17 53   20
33 34 3 4 33 34 11 11 33 34 3 4 36 37 11 11 31 32 3 4 29 30 11 11 33 34 3 4 36 37 11 11 33 34 3 4 29 30 11 11 56 57 58 59 78 73 79 80 3 4 33 34 27 28 3 4 81 82 74 83 62 63 64 64 3 4 11 11 3 4 11 11 3 4 11 11 3 4 27 28 11 11 56 57 84 73 79 80 33 34 33 34 42 43 48 15 16 17 70 71 70 71 3 4 17 17 64 85 17 17 70 71 86 87 86 87 20 20 17 17 64 85 17 17 17 40 88 89 7 35 33 34 42 43 81 82 74 83 64 64 62 63 64 64 64 64 65 66 67 68 33 34 3 4 33 34 3 4 33 34 3 4 33 34 3 4 27 28 3 4 56 57 58 59 17 69    20
1 2 3 4 1 2 11 11 1 2 3 4 51 52 11 11 9 10 3 4 49 50 11 11 1 2 3 4 51 52 11 11 1 2 3 4 49 50 11 11 72 58 73 20 20 20 90 91 3 4 1 2 12 13 3 4 21 22 20 20 20 20 20 39 3 4 11 11 3 4 11 11 3 4 11 11 3 4 12 13 11 11 72 58 73 92 90 91 1 2 1 2 3 4 14 15 16 17 39 77 39 77 3 4 20 20 20 93 94 95 39 77 87 87 87 87 42 43 20 20 20 93 94 95 54 55 88 89 5 6 1 2 3 4 21 22 20 20 20 20 20 20 20 20 20 20 20 74 75 76 1 2 3 4 1 2 3 4 1 2 3 4 1 2 3 4 12 13 3 4 72 58 73 20 20 20    20
33 34 3 4 33 34 11 11 31 32 3 4 33 34 11 11 27 28 3 4 36 37 11 11 33 34 3 4 33 34 11 11 27 28 3 4 36 37 56 57 84 73 79 80 31 32 33 34 3 4 33 34 33 34 3 4 33 34 3 4 31 32 31 32 3 4 11 11 3 4 11 11 3 4 11 11 3 4 31 32 56 57 84 73 79 80 31 32 33 34 33 34 3 4 48 15 16 17 17 17 17 17 3 19 70 71 3 4 74 85 17 17 86 87 86 87 3 19 70 71 3 4 74 85 17 17 88 89 36 37 33 34 3 4 33 34 31 32 3 4 27 28 3 4 27 28 81 82 74 75 67 68 3 4 33 34 3 4 33 34 3 4 33 34 3 4 33 34 3 4 78 73 79 80 48 16     20
1 2 3 4 1 2 11 11 9 10 3 4 1 2 11 11 12 13 3 4 51 52 11 11 1 2 3 4 1 2 11 11 12 13 3 4 51 52 72 58 73 92 90 91 9 10 1 2 3 4 1 2 1 2 3 4 1 2 3 4 9 10 9 10 3 4 11 11 3 4 11 11 3 4 11 11 3 4 9 10 72 58 73 92 90 91 9 10 1 2 1 2 3 4 14 15 16 17 17 17 17 17 18 19 39 77 3 4 96 74 94 95 39 87 87 87 18 19 39 77 3 4 96 74 94 95 88 89 51 52 1 2 3 4 1 2 9 10 3 4 12 13 3 4 12 13 21 22 97 74 75 76 3 4 1 2 3 4 1 2 3 4 1 2 3 4 1 2 3 4 20 39 90 91 14 16    20
62 63 60 61 62 63 62 63 62 63 60 61 62 63 62 63 62 63 60 61 62 63 62 63 62 63 60 61 62 63 62 63 62 63 60 61 62 63 78 73 62 63 62 63 62 63 62 63 60 61 62 63 62 63 60 61 62 63 60 61 62 63 62 63 60 61 62 63 60 61 62 63 60 61 62 63 60 61 62 63 78 73 62 63 62 63 62 63 62 63 62 63 60 61 98 15 16 17 64 85 17 17 60 61 17 17 60 61 17 99 74 100 39 87 86 87 60 61 64 85 60 61 17 99 74 100 101 89 62 63 62 63 60 61 62 63 62 63 60 61 62 63 60 61 62 63 62 63 62 63 74 83 60 61 62 63 60 61 62 63 60 61 62 63 60 61 62 63 60 61 62 63 62 63 98 16  20
20 20 20 20 20 20 20 20 20 20 20 20 20 20 20 20 20 20 20 20 20 20 20 20 20 20 20 20 20 20 20 20 20 20 20 20 20 20 20 20 20 20 20 20 20 20 20 20 20 20 20 20 20 20 20 20 20 20 20 20 20 20 20 20 20 20 20 20 20 20 20 20 20 20 20 20 20 20 20 20 20 20 20 20 20 20 20 20 20 20 20 20 20 20 20 20 20 20 20 93 20 20 20 20 20 20 20 20 20 20 20 20 87 87 87 87 20 20 20 93 20 20 20 20 20 20 20 20 20 20 20 20 20 20 20 20 20 20 20 20 20 20 20 20 20 20 20 20 20 20 20 20 20 20 20 20 20 20 20 20 20 20 20 20 20 20 20 20 20 20 20 20 20 20 20 20 20